X..............X
................
................
................
................
XXXXXX...XXXXXXX
X..............X
................
................
................
X..............X